-6
26
-6
26
111111111111111111111111111111111
111111111111111111111111111111111
111111111111111111111111111111111
111111111111111111111111111111111
111111111111111111111111111111111
111111111111111111111111111111111
111111111111111111111111111111111
111111111111111111111111111111111
111111100000000000000000011111111
111111104000000000000000011111111
111111100111000000001110011111111
111111100111000000001110011111111
111111100111000000001110011111111
111111100111000000001110011111111
111111100111000000001110011111111
111111100000000000000000011111111
111111100000000000000000011111111
111111100000000000000000011111111
111111100000000000000000011111111
111111100111000000001110011111111
111111100111000000001110011111111
111111100111000000001110011111111
111111100111000000001110011111111
111111100111000000001110011111111
111111100000000000000000011111111
111111100000000000000000011111111
111111111111111111111111111111111
111111111111111111111111111111111
111111111111111111111111111111111
111111111111111111111111111111111
111111111111111111111111111111111
111111111111111111111111111111111
111111111111111111111111111111111
