0
38
0
37
111111111111111111111111111111111111111
111111111111111111111111111111111111111
100000000000000000000000000000000000011
100000000000000000000000000000000005011
100000000000000000000000000000000000011
100000000000000000000000000000000000011
100000000000000000000000000000000000011
100000000000000000000000000000000000011
100000000000000000000000000000000000011
100000000000000000000000000000000000011
100000000000000000000000000000000000011
100000000000000000000000000000000000011
100000000000000000000000000000000000011
100000000000000000000000000000000000011
100000000000000000000000000000000000011
100000000000000000000000000000000000011
100000000000000000000000000000000000011
100000000000000000000000000000000000011
100000000000000000000000000000000000011
100000000000000000000000000000000000011
100000000000000000000000000000000000011
100000000000000000000000000000000000011
100000000000000000000000000000000000011
100000000000000000000000000000000000011
100000000000000000000000000000000000011
100000000000000000000000000000000000011
100000000000000000000000000000000000011
100000000000000000000000000000000000011
100000000000000000000000000000000000011
100000000000000000000000000000000000011
100000000000000000000000000000000000011
100000000000000000000000000000000000011
100000000000000000000000000000000000011
100000000000000000000000000000000000011
100000000000000000000000000000000000011
100000000000000000000000000000000000011
103000000000000000000000000000000000011
111111111111111111111111111111111111111
