0
20
0
20
111111111111111111111
111111111111111111111
100000000000000000011
100000000001111111011
100000000001111111011
100000000001111111011
100000000001111111011
100000000001111111011
100000000001111111011
100000000001111111011
100000000000000000011
100000000000000000011
100000000000000000011
100000000000000000011
100000000000000000011
100000000000000000011
100000000000000000011
100000000000000000011
100000000000000000011
100000000000000000011
111111111111111111111
