-15
12
-6
7
0000000000000000000000000000
0000000000000000011111111010
0000000000000000011111110000
1000000001000000011111110000
0000000000000000011111110000
0000000000000000011111110000
0000000000000000011111110000
0000000000000000111111110000
0000000000000000011111110000
0000000000000000011111110000
0100000000000000011111110000
0000000000000000011111110000
0000000100000000011111110000
0000000000000000011111110000
