-6
44
-6
43
111111111111111111111111111111111111111111111111111
111111111111111111111111111111111111111111111111111
111111111111111111111111111111111111111111111111111
111111111111111111111111111111111111111111111111111
111111111111111111111111111111111111111111111111111
111111111111111111111111111111111111111111111111111
111111111111111111111111111111111111111111111111111
111111111111111111111111111111111111111111111111111
111111100000000000000000000000000000000000011111111
111111100000000000000000000000000000000000011111111
111111100000000000011000000000000100000050011111111
111111100000100000011000000000000100000000011111111
111111100000100000000000000000000000000000011111111
111111100000000000000000000100000000000000011111111
111111100000000000000000000100000000000000011111111
111111100110000000000000000000000000000000011111111
111111100110000000000000000000000000000000011111111
111111100000000001000000000000000000000000011111111
111111100000000001000000000000000000000000011111111
111111100000000000000000110000000000000000011111111
111111100000000000000000110000000000011000011111111
111111100000000000000000000000000000011000011111111
111111100000000000000000000000000000000000011111111
111111100000000000000000000000000000000000011111111
111111100000000000000000000000001000000000011111111
111111100110000000000000000000001000000000011111111
111111100110000000000000000100000000000000011111111
111111100000000000000000000100000000000000011111111
111111100000000000000000000000000000000000011111111
111111100000000000000000000000000000000000011111111
111111100000000011000000000000000000000010011111111
111111100000000011000000000000000000000010011111111
111111100000000000000000000000000000000000011111111
111111100000000000000000000000000000000000011111111
111111100000000000000000000010000000000000011111111
111111100000000000000000000010000000000000011111111
111111100000010000000000000000000011000000011111111
111111100000010000000000000000000011000000011111111
111111100000000000000000000000000000000000011111111
111111100000000000000000000000000000000010011111111
111111100000000000000110000000000000000010011111111
111111100300000000000110000000000000000000011111111
111111100000000000000000000000000000000000011111111
111111111111111111111111111111111111111111111111111
111111111111111111111111111111111111111111111111111
111111111111111111111111111111111111111111111111111
111111111111111111111111111111111111111111111111111
111111111111111111111111111111111111111111111111111
111111111111111111111111111111111111111111111111111
111111111111111111111111111111111111111111111111111
