-6
26
-6
26
111111111111111111111111111111111
111111111111111111111111111111111
111111111111111111111111111111111
111111111111111111111111111111111
111111111111111111111111111111111
111111111111111111111111111111111
111111111111111111111111111111111
111111111111111111111111111111111
111111100000000000000000011111111
111111103000000000000000011111111
111111100000000000110000011111111
111111100000000001111110011111111
111111100011100001111111011111111
111111100011100001111111011111111
111111100011100001111111011111111
111111100000000001111000011111111
111111100000000001111000011111111
111111100000000000000000011111111
111111100001100000110000011111111
111111100011110001111000011111111
111111100011110001111000011111111
111111100011110001111000011111111
111111100011110001111000011111111
111111100011110001111000011111111
111111100011110001111000011111111
111111100000000000000000011111111
111111111111111111111111111111111
111111111111111111111111111111111
111111111111111111111111111111111
111111111111111111111111111111111
111111111111111111111111111111111
111111111111111111111111111111111
111111111111111111111111111111111
