51
96
-47
-4
1111111111111111111111111111111111111111111111
1111111111111111111111111111111111111111111111
1111111111111111111111111111111111111111111111
1111111111111111111111111111111111111111111111
1111111111111111111111111111111111111111111111
1111111111111111111111111111111111111111111111
1111111111111111111111111111111111111111111111
1111111111111111111111111111111111111111111111
1111111000000000000000000000000000000011111111
1111111040000000000000000000000111002011111111
1111111000000000000000000000000111000011111111
1111111000000000000001000000000000000011111111
1111111000000000000001000000000000000011111111
1111111000000000000000000000000000000011111111
1111111000000000000000000000000000000011111111
1111111000100000000000000000000000000011111111
1111111000100000000000000000000000000011111111
1111111000000000000000000000000000000011111111
1111111000000000000000000000000111000011111111
1111111000000001110000000000000111000011111111
1111111000000001110000000000000000000011111111
1111111000000000000000000000000000000011111111
1111111000000000000000000000000000000011111111
1111111000000000000000000000010000000011111111
1111111000000000001000000000010000000011111111
1111111000000000001000000000000000000011111111
1111111000000000000000000000000000000011111111
1111111000000000000000000000000000000011111111
1111111111000000000000000000000000000011111111
1111111111000000000000000000001110000011111111
1111111000000000000000000000001110000011111111
1111111000000000000000000000000000000011111111
1111111000000000000000000000000000000011111111
1111111000000000000000111000000000000011111111
1111111000001000000000111000000000000011111111
1111111000001000000000000000000000000011111111
1111111000000000000000000000000000000011111111
1111111111111111111111111111111111111111111111
1111111111111111111111111111111111111111111111
1111111111111111111111111111111111111111111111
1111111111111111111111111111111111111111111111
1111111111111111111111111111111111111111111111
1111111111111111111111111111111111111111111111
1111111111111111111111111111111111111111111111
