57
90
-41
-10
1111111111111111111111111111111111
1111111111111111111111111111111111
1000000000000000000000000000000011
1040000000000000000000000111002011
1000000000000000000000000111000011
1000000000000001000000000000000011
1000000000000001000000000000000011
1000000000000000000000000000000011
1000000000000000000000000000000011
1000100000000000000000000000000011
1000100000000000000000000000000011
1000000000000000000000000000000011
1000000000000000000000000111000011
1000000001110000000000000111000011
1000000001110000000000000000000011
1000000000000000000000000000000011
1000000000000000000000000000000011
1000000000000000000000010000000011
1000000000001000000000010000000011
1000000000001000000000000000000011
1000000000000000000000000000000011
1000000000000000000000000000000011
1111000000000000000000000000000011
1111000000000000000000001110000011
1000000000000000000000001110000011
1000000000000000000000000000000011
1000000000000000000000000000000011
1000000000000000111000000000000011
1000001000000000111000000000000011
1000001000000000000000000000000011
1000000000000000000000000000000011
1111111111111111111111111111111111
