0
20
0
20
111111111111111111111
111111111111111111111
100000000000000000011
100000000000000000011
100000000001111000011
100000000001111110011
100011100001111111011
100011100001111111011
100011100001111111011
100000000001111100011
100000000001111100011
100000000000000000011
100011110001111000011
100011110001111000011
100011110001111000011
100011110001111000011
100011110001111000011
100111110001111100011
100111110001111100011
100000000000000000011
111111111111111111111
