-15
15
-11
11
0000000000000000000000000000000
1111111111111111111111111111110
1000000000000000000000000000010
1000000000000000000000000000010
1000000000000000000000000000010
1000000000000000000000001010010
1000000000000000000000000000010
1000000001000000000000000000010
1000000000000000011111110000010
1000000000000000011111110000010
1000000000000000011111110000010
1000000000000000111111110000010
1000000000000000011111110000010
1000000000000000011111110000010
1100000000000000011111110000010
1000000000000000000000000000010
1000000100000000000000000000010
1000000000000000000000000000010
1000000000000000000000000000010
1000000000000000000000000000010
1000000000000000000000000000010
1000000000000000000000000000010
1111111111111111111111111111110
