-15
15
-11
11
0000000000000000000000000000000
0000000000000000000000000000000
0000000000000000000000000000000
0000000000000000000000000000000
0000000000000000000000000000000
0000000000000000000000001010000
0000000000000000000000000000000
1000000001000000000000000000000
0000000000000000011111110000000
0000000000000000011111110000000
0000000000000000011111110000000
0000000000000000111111110000000
0000000000000000011111110000000
0000000000000000011111110000000
0100000000000000011111110000000
0000000000000000000000000000000
0000000100000000000000000000000
0000000000000000000000000000000
0000000000000000000000000000000
0000000000000000000000000000000
0000000000000000000000000000000
0000000000000000000000000000000
0000000000000000000000000000000
